■─■─■─■─■
│ │ │   │
■─■ ■─■─■
│ │ │ │ │
■ ■─■ ■─■
│   │ │ │
■─■─■─■─■
    │   │
    ■─■ ■
      │ │
      ■─■
