■─■─■      
│ │ │      
■ ■─■      
│ │        
■ ■─■ ■─■  
│ │ │ │ │  
■─■ ■─■ ■─■
│ │ │ │   │
■ ■─■─■─■─■
│ │ │     │
■─■─■─■─■─■
