■─■─■ ■─■─■─■
│ │ │ │ │   │
■─■ ■ ■ ■─■─■
  │ │ │ │ │  
  ■ ■─■─■ ■─■
  │ │   │ │ │
  ■─■─■─■─■─■
      │     │
      ■─■─■─■
